1111111111111111111111111111111111111111111
1E000000000000000000000C0000000000000000001
1010010100101001010010100101001010010000101
1000010100001000000000000000000000110000001
1010010100100000000000000000000000000000001
1010010100101000000000000000000000000000001
1010010100101000000000000100000000010000001
1P0000000000C000000C0000E000000100000000001
100000000000000XX00000000000000000000000001
1000000000000000000000000000000000000000001
11111111111100000X0000000000000000000000001
1000000000000000000000000000000000000000001
1111111111111111111111111111111111111111101
1000000000000000000000000000000000000000001
1011111111111111111111111111111111111111111
10000000000000000000000000000000000000000E1
1111111111111111111111111111111111111111111
