1111111111111111111111111111111111111111111
1E000000000000000XXXC0111000000000000000001
1010010100101001010010100101001010010000101
10000101000010000000000X0000000000110000001
1010010100100000000000000000000000000000001
1010010100101000000000X00110011000X00000001
10100101001010000000X0000100000000010000001
1P0000000000C000000C0000E000000100000000001
1000000001111000XX00000E0000000000000000001
1111111111111111111111111111111111111111101
1000000000000000000000000000000000000000001
1011111111111111111111111111111111111111111
10000000000000000000000000000000000000000E1
1111111111111111111111111111111111111111111
